111111111111111
133333332222331
101012121212101
122033222232321
131210121212121
122230232323221
121210121212121
122322322322221
131012131212121
122222322232221
131313131212121
123232223232221
131212121213131
103232223222301
111111111111111